|H &&&&&&&&&   |H $$  Plinko |  &&&       H|
|H============ =H=========================H|
|H  V           H    V             V      H|
|*   |          H     |            |   |   |
|=====    |                       |        |
| |      |    |      |     |            |  |
|          |      |     |        |  |      |
|      |       |      |                    |
|H  | |V  | |    |  |     |    |   |    |  |
|H             |     | |          |        |
|H   |  |          |        |   |  | |     |
|H |          |     | |       |         |  |
|H     |  |      |     |   |     |  |      |
|H                |  |         |      |  | |
|H  |      | |          |    |    |        |
|H     |  &     |   |     |          | |   |
|H  |     |   |        |       | |      | ||
|H |  | |    |       |     |  |   | | |    |
|H       |  |     |      |   |          |  |
|= |   |     | |      |            |  |    |
|     |   |        |       |    |   |   |  |
| |        |    |     |   | |          |   |
|    |   |   |    |          |     |       |
|  |            |      |       |     |  | ||
||        | |       |     |        |       |
|     |       |             |    |      |  |
| |       |     |       |           |      |
|*                 p                      *|
============================================
