&                                                              
V                                                              
                 V                    V                        
|           &          &          &                           |
===         ============          =====  -------              |
                                                          .  $|
=  == ===========.=============   ====H==      ==H===     =====
.                                     H  =       H             
|             ---======H        .     H   =      H             
|                      H              H    =  ======           
========  =====        ==----===      H     =       =          
                     |                H              =         
      H=====-        |     ======     H               =        
      H       ========            HHHHHHHHHHH.                 
    ==H==   .  | SNP |            H                  ====      
      H     .  |     |       H====H                   |        
      H       =------        H                   -----|   =   |
      H     .     ^^         H                  |-----|  =    |
* p   H     .     ^^         H                 *| &&& |    & *|
===============================================================
